XXXXOXXXXX
XOOOOOOOOX
XOOOOOOOOX
XOOOOOOOOX
XOOOOOOOOO
XOOOOOOOOX
XOOOOOOOOX
XOOOOOOOOX
XOOOOOOOOX
XXXXXXXXXX