XXXXOXXXXX
XOOOOOOOOX
XOOOOOOOOX
XOOOOOOOOX
OOOOOOOOOX
XOOOOOOOOX
XOOOOOOOOX
XOOOOOOOOX
XOOOOOOOOX
XXXXXXXXXX