XXXXXXXXXX
XOOOOOOOOX
XOOOOOOOOX
XOOOOOOOOX
OOOOOOOOOX
XOOOOOOOOX
XOOOOOOOOX
XOOOOOOOOX
XOOOOOOOOX
XXXXOXXXXX