XXXXXXXXXX
XOOOOOOOOX
XOOOOOOOOX
XOOOOOOOOX
XOOOOOOOOO
XOOOOOOOOX
XOOOOOOOOX
XOOOOOOOOX
XOOOOOOOOX
XXXXOXXXXX